⠀⠀⠀⠀⠀⠀⠀⠀⠀⠀⠀⠀⠀⠀⢀⣀⣄⣠⣀⡀⣀⣠⣤⣤⣤⣀⠀⠀⠀⠀⠀⠀⠀⠀⠀⠀⠀⠀⠀⠀⠀⠀⠀⠀⠀⠀⠀⠀⠀⠀⠀⠀⠀⠀⠀⠀⠀⠀⠀⠀⠀⠀⠀
⠀⠀⠀⠀⠀⠀⠀⠀⠀⠀⣄⢠⣠⣼⣿⣿⣿⣟⣿⣿⣿⣿⣿⣿⣿⣿⡿⠋⠀⠀⠀⢠⣤⣦⡄⠀⠀⠀⠀⠀⠀⠀⠀⠀⠀⠰⢦⣄⠀⠀⠀⠀⠀⠀⠀⠀⠀⠀⠀⠀⠀⠀⠀
⠀⠀⠀⠀⠀⠀⠀⠀⣼⣿⣟⣾⣿⣽⣿⣿⣅⠈⠉⠻⣿⣿⣿⣿⣿⡿⠇⠀⠀⠀⠀⠀⠉⠀⠀⠀⠀⠀⢀⡶⠒⢉⡀⢠⣤⣶⣶⣿⣷⣆⣀⡀⠀⢲⣖⠒⠀⠀⠀⠀⠀⠀⠀
⢀⣤⣾⣶⣦⣤⣤⣶⣿⣿⣿⣿⣿⣿⣽⡿⠻⣷⣀⠀⢻⣿⣿⣿⡿⠟⠀⠀⠀⠀⠀⠀⣤⣶⣶⣤⣀⣀⣬⣷⣦⣿⣿⣿⣿⣿⣿⣿⣿⣿⣿⣿⣿⣿⣿⣿⣶⣦⣤⣦⣼⣀⠀
⠈⣿⣿⣿⣿⣿⣿⣿⣿⣿⣿⣿⣿⡿⠛⠓⣿⣿⠟⠁⠘⣿⡟⠁⠀⠘⠛⠁⠀⠀⢠⣾⣿⢿⣿⣿⣿⣿⣿⣿⣿⣿⣿⣿⣿⣿⣿⣿⣿⣿⣿⣿⣿⣿⣿⣿⣿⣿⣿⡿⠏⠙⠁
⠀⠸⠟⠋⠀⠈⠙⣿⣿⣿⣿⣿⣿⣷⣦⡄⣿⣿⣿⣆⠀⠀⠀⠀⠀⠀⠀⠀⣼⣆⢘⣿⣯⣼⣿⣿⣿⣿⣿⣿⣿⣿⣿⣿⣿⣿⣿⣿⣿⣿⣿⣿⣿⣿⡉⠉⢱⡿⠀⠀⠀⠀⠀
⠀⠀⠀⠀⠀⠀⠀⠘⣿⣿⣿⣿⣿⣿⣿⣿⣿⣿⣟⡿⠦⠀⠀⠀⠀⠀⠀⠀⠙⣿⣿⣿⣿⣿⣿⣿⣿⣿⣿⣿⣿⣿⣿⣿⣿⣿⣿⣿⣿⣿⣿⣿⣿⡿⡗⠀⠈⠀⠀⠀⠀⠀⠀
⠀⠀⠀⠀⠀⠀⠀⠀⢻⣿⣿⣿⣿⣿⣿⣿⣿⠋⠁⠀⠀⠀⠀⠀⠀⠀⠀⠀⢿⣿⣉⣿⡿⢿⢷⣾⣾⣿⣞⣿⣿⣿⣿⣿⣿⣿⣿⣿⣿⣿⣿⣿⠋⣠⠟⠀⠀⠀⠀⠀⠀⠀⠀
⠀⠀⠀⠀⠀⠀⠀⠀⠀⠹⣿⣿⣿⠿⠿⣿⠁⠀⠀⠀⠀⠀⠀⠀⠀⠀⠀⣀⣾⣿⣿⣷⣦⣶⣦⣼⣿⣿⣿⣿⣿⣿⣿⣿⣿⣿⣿⣿⣿⣿⣷⠈⠛⠁⠀⠀⠀⠀⠀⠀⠀⠀⠀
⠀⠀⠀⠀⠀⠀⠀⠀⠀⠀⠉⠻⣿⣤⡖⠛⠶⠤⡀⠀⠀⠀⠀⠀⠀⠀⢰⣿⣿⣿⣿⣿⣿⣿⣿⣿⣿⣿⣿⡿⠁⠙⣿⣿⠿⢻⣿⣿⡿⠋⢩⠀⠀⠀⠀⠀⠀⠀⠀⠀⠀⠀⠀
⠀⠀⠀⠀⠀⠀⠀⠀⠀⠀⠀⠀⠀⠈⠙⠧⣤⣦⣤⣄⡀⠀⠀⠀⠀⠀⠘⢿⣿⣿⣿⣿⣿⣿⣿⣿⣿⣿⡇⠀⠀⠀⠘⣧⠀⠈⣹⡻⠇⢀⣿⡆⠀⠀⠀⠀⠀⠀⠀⠀⠀⠀⠀
⠀⠀⠀⠀⠀⠀⠀⠀⠀⠀⠀⠀⠀⠀⠀⢠⣿⣿⣿⣿⣿⣤⣀⡀⠀⠀⠀⠀⠀⠀⠈⢽⣿⣿⣿⣿⣿⠋⠀⠀⠀⠀⠀⠀⠀⠀⠹⣷⣴⣿⣷⢲⣦⣤⡀⢀⡀⠀⠀⠀⠀⠀⠀
⠀⠀⠀⠀⠀⠀⠀⠀⠀⠀⠀⠀⠀⠀⠀⠈⢿⣿⣿⣿⣿⣿⣿⠟⠀⠀⠀⠀⠀⠀⠀⢸⣿⣿⣿⣿⣷⢀⡄⠀⠀⠀⠀⠀⠀⠀⠀⠈⠉⠂⠛⣆⣤⡜⣟⠋⠙⠂⠀⠀⠀⠀⠀
⠀⠀⠀⠀⠀⠀⠀⠀⠀⠀⠀⠀⠀⠀⠀⠀⠀⢹⣿⣿⣿⣿⠟⠀⠀⠀⠀⠀⠀⠀⠀⠘⣿⣿⣿⣿⠉⣿⠃⠀⠀⠀⠀⠀⠀⠀⠀⠀⠀⣤⣾⣿⣿⣿⣿⣆⠀⠰⠄⠀⠉⠀⠀
⠀⠀⠀⠀⠀⠀⠀⠀⠀⠀⠀⠀⠀⠀⠀⠀⠀⣸⣿⣿⡿⠃⠀⠀⠀⠀⠀⠀⠀⠀⠀⠀⢹⣿⡿⠃⠀⠀⠀⠀⠀⠀⠀⠀⠀⠀⠀⠀⠀⢻⣿⠿⠿⣿⣿⣿⠇⠀⠀⢀⠀⠀⠀
⠀⠀⠀⠀⠀⠀⠀⠀⠀⠀⠀⠀⠀⠀⠀⠀⢀⣿⡿⠛⠀⠀⠀⠀⠀⠀⠀⠀⠀⠀⠀⠀⠀⠀⠀⠀⠀⠀⠀⠀⠀⠀⠀⠀⠀⠀⠀⠀⠀⠀⠀⠀⠀⠈⢻⡇⠀⠀⢀⣼⠗⠀⠀
⠀⠀⠀⠀⠀⠀⠀⠀⠀⠀⠀⠀⠀⠀⠀⠀⢸⣿⠃⣀⠀⠀⠀⠀⠀⠀⠀⠀⠀⠀⠀⠀⠀⠀⠀⠀⠀⠀⠀⠀⠀⠀⠀⠀⠀⠀⠀⠀⠀⠀⠀⠀⠀⠀⠀⠀⠀⠀⠙⠁⠀⠀⠀
⠀⠀⠀⠀⠀⠀⠀⠀⠀⠀⠀⠀⠀⠀⠀⠀⠀⠙⠒
